....................................................................................................
....................................................................................................
....................................................................................................
....................................................................................................
....................................................................................................
.................................................-=.................................................
...............................................=@@@@+...............................................
.............................................+@@@@@@@@*.............................................
...........................................+%#@@::-.@@##*...........................................
.........................................##=@@=..**..-@@+*#.........................................
.......................................%*:@@*..#@@@@%..+@@-+@:......................................
.....................................%*.%@%.:%@@@@@@@@@:.%@%.+@:....................................
..................................:@+.+@@--@@@@@@@@@@@@@@=-@@*.-@-..................................
................................=@-.-@@==*+=+++****#**++++*=-@@=.-@+................................
..............................:@-..@@#*..........**..........**@@:.:@-..............................
............................=@:..#@@#=...........**...........-#@@#..:%+............................
..........................+@-..+@@%::............**..............#@@#..:@+..........................
.........................%#:-#@@@:...............**................@@@#-:*@.........................
........................%#..-@@+..=..............**..............-..=@@=..*@........................
......................-:@..+@%%..-...............**...............-..#%@*..%-=......................
.....................-.@:.*@#=:.-................**................=..=*@#.:@.-:....................
...................+..@:.#@+.*..-................**................:..*.-@%.:@..+...................
..................=..+*.#@=.*..+.................**.................=..*.-@%.=*..::.................
................-...+#.@@-.--.=..................**..................+.-=.:@@.**...-................
..............*+...:%:@@:..#.-...................**...................=.*:.:@@-#-...=#..............
.............-.....@-@@:..*..=...................**...................-..#...@@=@.....=.............
...........::.....@#@%...--.-....................**....................-.:=...%@#@.....:-...........
..........=......##@%....*.*.....................**.....................*.*....*@#%......-..........
........-......-#@@#....*.:......................**......................-.*....+@@#=......-........
.......-.....::+@@#.....=-......................:**:......................-=:....+@@*.-.....:.......
.....-.....--.:@@+.....#.=.:....................:**.....................::-:#.....=@@=.:-.....-.....
....-....:-..:@@@########*#######################%########################*##%#####%@@-..::....::...
..+.....=....@@@@@@@@@@#@@@@@@@@@@@@@@@@@@@@@@@@@%#@@@@@@@@@@@@@@@@@@@@@@@@@@@%@@@@@@@@:...=:....+..
:-++.:*....:@@@@@@@@@#%@@@@@@@@@@@@@@@@@@@@@@@@@@%#@@@@@@@@@@@@@@@@@@@@@@@@@@%#@@@@@@@@@:....+:.-+::
...@#....=:@@@@@@@@@#%@@@@@@@@@@@@@@@@@@@@@@@@@@@@#@@@@@@@@@@@@@@@@@@@@@@@@@@@@#@@@@@@@@@==....*@:..
..:-@**%%@@@@@@@@@@@@@@@@@@@@@@@@@@@@@@@@@@@@@@@@@@@@@@@@@@@@@@@@@@@@@@@@@@@@@@@@@%@@@@@@@@%%**@=:..
.....:--::....-..::............-:........:::...........--:..........:-...........::..-....:::-:.....
....................................................................................................
....................................................................................................
....................................................................................................
....................................................................................................
....................................................................................................
....................................................................................................