
.@@@@@@@@@@@@@@@@@@@@@@@@@@....................%@@@@.....................@@@@@@@@@@@@@@@@@@@@@@@@@@
.@@@@@@@@@@@@@@@@@@@@@@@@.....................@@@@@@@@....................:@@@@@@@@@@@@@@@@@@@@@@@@
.@@@@@@@@@@@@@@@@@@@@@@*....................@@@..@@..@@@....................@@@@@@@@@@@@@@@@@@@@@@@
.@@@@@@@@@@@@@@@@@@@@@....................@@@....@@....@@@....................@@@@@@@@@@@@@@@@@@@@@
.@@@@@@@@@@@@@@@@@@@....................@@@......@@......@@@....................@@@@@@@@@@@@@@@@@@@
.@@@@@@@@@@@@@@@@@....................@@@........@@.......:@@%...................:@@@@@@@@@@@@@@@@@
.@@@@@@@@@@@@@@@....................@@@..........@@.........=@@-...................@@@@@@@@@@@@@@@@
.@@@@@@@@@@@@@+...................=@@+...........@%...........@@@....................@@@@@@@@@@@@@@
.@@@@@@@@@@@@...................:@@-.............@@.............@@@....................@@@@@@@@@@@@
.@@@@@@@@@@....................@@@.............@@@@@#.............@@@....................@@@@@@@@@@
.@@@@@@@@....................@@@.............*@@....@@-.............@@@...................:@@@@@@@@
.@@@@@@....................@@@.............%@@........@@#.............@@@...................@@@@@@@
.@@@@....................#@@..............@@............@@..............@@....................@@@@@
.@@#.@@@...............@@@.............:@@.....@@@@@@.....@@.............=@@................@@@.@@@
.-.......:@@=........-@@..............@@....@@....:...@@....@@.............#@@..........@@-.......@
...............@@+..@@@.............@@...@@.......:......@@...@@.............@@@..:@@..............
..................@@@:@*..........@@...@*.........:........@@...@@..........:@+@@@.................
................*@@@.......@:...@@...@............:..........=@...@@....@.......@@@................
...............@@@@...........@@....@.............:...........%@...*@@...........@@@@..............
..............@@..:..........@@:....@.............:............@.....@@..........@..@@.............
............@@...@.........@@:.....@.@............:...........-%@.....@@-.........@..@@............
...........@@...=.........@@.......@:.............:............#@.......@@........:....@+..........
..........@@...**........@@........:..............:.............*........@@........@....@@.........
.........@=....@........@@........%..............................@........@@........@....@@........
........@@@@@@*........@@........................................#.........@@........#@@@@@@.......
......................@@.........@+..............................@@.........@@.....................
.....................@+..........@................:...............@..........%@....................
...................=@...........@..=..............:................@...........@:..................
...:..............@@*.....:-@*+@+%#@@@@###%##@@%++++%@@%#****@@@@@@@@+*@-......@@-.................
..:...........@@@@@@@@@@@@@@@@@@@@@@@@@@@@@@@@@@@@@@@@@@@@@@@@@@@@@@@@@@@@@@@@@@@@@@@@.............
.........%@@@@@@@@@@@@@@@@@@.*@..........................:..........:@+.@@@@@@@@@@@@@@@@@@:........
....#@@@@@@@@@@@@@@@@@@@....*@=%.....................................@@=....@@@@@@@@@@@@@@@@@@@*...
.@@@@@@@@@@@@@@@@@@@@..................:@@......#@#.......@@..................:@@@@@@@@@@@@@@@@@@@@
.@@@@@@@@@@@@@@@@@....................=@@......@@@@@......@@@.........:*:.........@@@@@@@@@@@@@@@@@
.@@@@@@@@@@@@@@............@@@.......@@@@.......%@@.......@@@@*.......@@@............@@@@@@@@@@@@@@
.@@@@@@@@@@.........................@@@@....................@@@@........#................@@@@@@@@@@
.@@@@@@@-.....................=..-@@@@@@@.....*.....@.....@@@@@@@@.........................@@@@@@@@
.@@@@+#@@@@@@@@@@@@@@@@@@@@=....*@@@@@@.......@.....@........@@@@@@@....@@@@@@@@@@@@@@@@@@@@@*#@@@@
.@@@@@@@@@@@@@@@@@@@@@@@@@@@@@@.@@@@@@@@@......@@@@@......*@@@@@@@@@.@@@@@@@@@@@@@@@@@@@@@@@@@@@@@@
.@@@@@@@@@@@@@@@@@@@@@@@@@@**@@@@@@@@@@@@@*...%@@@@@@...:@@@@@@@@@@@@@@*#@@@@@@@@@@@@@@@@@@@@@@@@@@
.@@@@@@@@@@@@@@@@@@@@@@@@@@@@@@@@@@@@@@@@@:@@@@@@@@@@@@@*@@@@@@@@@@@@@@@@@@@@@@@@@@@@@@@@@@@@@@@@@@
