
....................................................................................................
....................................................................................................
....................................................................................................
....................................................................................................
....................................................................................................
.......................++++++++++++++++++++++++++++++++++++++++++++++++++++.........................
.....................+@*..+............................................+..+@+.......................
....................=@*..+..............................................+..+@+......................
...................+@=..+................................................+..=@+.....................
..................+@=..+..................................................+..-@+:...................
.................*@-.+.....................................................+..-@*:..................
................*@-..+......................................................+..@#...................
................#@-..+.......................................................+.-@#..................
..............:=@:..+........................................................+..:@=:................
.............:=@:..+..........................................................+..:@=:...............
............-#@:..+............................................................+..*@=...............
............=@::::::::::::::::::::::::::::::::::::::::::::::::::::::::::::::::::::::@=..............
............*@:.........................:+#*========+++#*:.........................:=@:.............
...........+@*............................-##=......=##-............................*@*:............
..........=*@=..............................==#-..-#==..............................=@*=:...........
.........==+@:................................+=**=*................................:@+-+...........
........-=:*@:.................................:##:.............:....................*@-:+..........
.......-=.-@=..................................................:.....................=@=.:*.........
......-=..+@-.................................................:......................:@+..:*........
.....-=..:@*:.........................................................................+@:..:+.......
....-=...-@=..........................................................................=@=...:+......
...-=....+@-.......................:::................................................-@*....:=:....
..:=:...:@*............................................................................+@:....-=....
.:+:....=@=............................................................................=@=.....-+...
.*:.....*@-............................................................................:@*......:+..
*:......=@########*#######################=########################*##=#######*########=@=.......:..
:......-@@@@@@@@@@@@@@@@@@@@@@@@@@@@@@@@@@@@@@@@@@@@@@@@@@@@@@@@@@@@@@@@@@@@@@@@@@@@@@@@@@-.......:+
:......-@@@@@@@@@@@@@@@@@@@@@@@@@@@@@@@@@@@@@@@@@@@@@@@@@@@@@@@@@@@@@@@@@@@@@@@@@@@@@@@@@@-........:
:......-@@@@@@@@@@@@@@@@@@@@@@@@@@@@@@@@@@@@@@@@@@@@@@@@@@@@@@@@@@@@@@@@@@@@@@@@@@@@@@@@@@-.........
....................................................................................................
................................................................:-=================:................
...........--------:................................................................................
....................................................................................................
.............................................................--------:..............................
...................:-=================:.............................................................
....................................................................................................
....................................................................................................