##########**##%*+#%*%%%####*++*###%##%#%-:-%-%--.:+%**-=-=-=*#%#=*##%**+#%++**##*################*
#%%%%%%%%%%%#%%%%%##@%+**#%*%@%##%%**%@#*+%@%==@@*++%+%%*=+#@#*%%%%#%**#%+*@%*#%%%%%%%%%#%%##%%%%#
#%%%%%%%%##%@%###@#@@#%%%@%*@%%@#%#%@*%%#%#%##*+*--*##*#@#%%*#+++@%+%*#%%@#+###%#%%%%%%%%%%%%%%%%#
#%%%%%%###%#%#%%%@%@##@##%+%*%*##%#%##%@%*%#*+++=+=#+%@*%@+**%%@#%%+%%@%+**@##%%#%#%%%%%%%%%%%%%%#
#%%%%%%%@@%#####+#%#%%#*%%#@*@@*#@#%#@#%*@%#*+##%++-=*%@+*%%#%+%+#%%@%##***##+#%%%%#%%%%%###%%%#%#
#%%%%%%####%%@*#*@##%##=@%@%@**#@@%%++*%*@**@*+@@+#%#*++%#%+%%=%%#%%#*%#*@@@@@#+%*%##%%%%%#%%%%%%#
#%%%%%%%#%#%%%%%%@@####%@#**=*#%@*+%%@%%%%*%%+*==+%%@%=%%**%+@@@@@%%%#@@*##**##@#@@##@%%%%#%%%%%%#
#%%%%%%%%#%%#%%*%%@#+@**%*#%*%@@%@%@#-=#*%=@=%@%@=+*%+##%#@%%#%###%%@*+%*%%+@*##*#%##%%%%%##%%%%%#
#%%%%%%%#%%%%@%*@*#*%**@**%%@@**+#@@@%@%%%+#%*****@*=:+*#%+%%#%%%=*%#+@%**%*%##%**%%#%%%%%%%%%%%%#
#%%%%#%%#%%#*%#@@#%#+*@@@@@%%#%%##+=+@%%*++*=+%+*++#+*%#:+#=*%+#@%%%%###*=#*%*#%+*%%%%%%%%%%#%%%%#
#%%%%#%#%@%##%#%#%##@@@%=+%%++*=#=#@*%%+--#%#*+=+=##+#+*=-+*@@*%%@#%%**##%+#*#%%+##%*@%%%%%%#%%#%#
#%%%%%%%@%%###@%%@@@@*###%@*%##+#++=+@@#%@---*+*@#***=#+#:*:#=-@%*@%#+*@#@*@*%*%%##@##%%%%%%%%%#%#
#%%%#%%%#+%##*%@@@#+##%#%%++%**++#+=+=@@+:+#=#++*+@+**@*#=%#=%+@%=%%@%-%*#*%+#*%#+#@##@#%%%%#%%%%#
#%%##%%###@%%%@%=#*+%*@%%@##++*#+:*+#*@##++#+#=#@-##.+=@@*#+##=+@=%%@=#*##*%#%*%#*%%%%%#%%%%%#%%%#
#%%#%%%%%%%%%%%*#%#@*%*@**+*#***=*++*=@%#+*#**%*:.*%@**==+++##*+@-%%#=*@#+*#*#%%%*%%%*@#%%%%%#%%%#
#%%%%%%%%%%%*%@%%%%#+@*#+#*+*+-+*+#@*-@%#+*+%#+##@*+++%@@%*==+#=:@%@+-++%@+%*#*%##*%%+@%#%%%%%%%%#
#%%%%%%%%%%#@%#*##+%*#+++#+*+#**#**=#=%%++##+=#**==***-++*#%#***+@%@=-+==#@*##*%#%+#@#%%#%%%%%%###
#%%%%%#%###*#%%+#@@+%****++#=%*#**==*@%%%@*=**+:-*@*##*+*+@##*+*.@@@=*+*=#*@##+%%%#*@%%@##%%%%%%%#
#%%%%%#%@%**%%#+@#++###*%*%#%**#*=+*+#%@#=*=**==#+#=++##-*@*-#-=-%%#*#+-+%*+@@=#%+#*@%=@@#%%%%%###
#%%%###@##*#%%#@#+*+#++%%*++#*%#=#%*+#%%*-***+-##++#***#--==#@**#@%@%+@++%#+#%##%+*%@%+#@#%%%%%%%#
#%%%#%@*##+#%@@##+%%#%#+==%%##*+****+%%%*=#*#*#*+*=*=++#%*#*=@*:%%@+ :=%@=*+#**@%+*%%%*#@%#%%%%%%#
#%%%#@#*%%+%@%*%#+*%#*+%%#%#*#++#++*=@%%+*#+++*=%==***+#*-+*:*#+#%@++==-*%%*#=%#%%%+%%=*@%#%%%%%%#
#%%%%####+@%%+#%*#%**+#%*+#+=*******=@%%+@+##%=+*=*-*+-=++*+==-%@%%=*+*#+%%+%*#%%+@#%%+*#@*%%%%%%*
#%%%###*%#%%#*%*##+%#%#*=%*+*#+++**+=@#@%*=+*+*+****#=-=+==*+*=#@%@+***++#@+##*@%%=@%%***@%#%%%%%#
#%%##%%%#+%@%%#*###%**+%@*#*#***##%=#@%**+%%#+=+*****#+=-*=====*%@#***#**=#%##*#%%=+@%*#*#@##%%%%#
#%%##%#%*%@%%**###%#***%=+*+#*++*+@.@@##+@:-++++*+++=+%#**=++==%%@==+**%*#%+%*#+%%*+@@*+**@%#%%%%#
#%%######%%*#**%+*%#+*@%+#*#++*#+++@%#=+@#****+*++***++**+*+++%%%@-*+*+*#*#*%#**%%*+#%#@%*@%%%%%%#
#%%##%##%%%*%*%***#***@****#+*%+**+@%@@-+=+++***++++++*=**=++++%%@-****#**#*#@**%%#+*%%**%@%%%%%%#
#%###%*%%%##%+%*#*####%+#*+**%++*+=@@##+*+=++*+*++*=+=+****+*+#@%@=++****###*%#*#%*#*%%#**#%%%%%%#
#%#####%%%*%*##***##**###**+**+**+#%%#==*+**+***+*++++++=*@*+++%%@=******+#*##%*#%**+%%#*#*%%%%%%#
#%###%#%%#*%%#####*#*%%*+#**%+*#*=@%%%+**+**++**++*++++==+=*#++@%@#+***+#****#%**##**%%#+#*%%%%%%#
#%#@#*%%##*%%*##*%#*@#+***+#**#++#@%%#+++++**+*+**++++*+**+==#-%@%#=***+**#**#+@*#%*+#%%***%%##%%#
#%####%%##*@#####%+*##**+#***+*#=%%%%*+*****++******++**+*++=*@%%##**+***+*#*#*###%**%%#*#*%%%#%%#
#@###%%%###%####%#**%***+%++***=@%%#*+##*+*****+**++++**+*+*++=@@%@@+*#*#****#++%##**#%%*###%%##%#
#@**%%%%#*#%###*%#**%#***#+***++@%%@@=*#+=**+******+++**+*++**=#@%%%*******#**#**@##**%%**#*%#%#%#
#%%##%%%##%%##**%#*#%+#+%#+*#%*#@%%*++%***##************+**++*+#%%%%+*+#***#*#%***%###%%#*%*%%%#%#
#%%%%%%%#+%#*#*###%%#*#*%**##**%%%%@#+%***####**********++*=+#++@%%%%+*+#+*#**#**+%#**#%%*###%%%##
#%%%%%%%%%%%##*@%#+%%#*#***##+@%%%%++*%**##*#*#***********#++*++@%%%%++*#+*##*##*+#%**%%%##*#%%%%#
#%%%#%%%%%%#%%###%###*##*#**+%%%%%@+*#%*###***#********#****+*++*@%%%##+*++##=##*##%%##%#%#%%#%#%#
#%%%%%%%%%%%%%#%#%#######%#%%@%%%@****#**#*+****+*********#+*++++@%%%%*+%#**#*##**##%##%%%#%#%%%%#
#%%%%%#%%%%@%#%#%*%#%##*##*#@#%%%%#####++#***+***********++*#+#%*%%%%%@+*@**#*####*#####%##%%#%%%#
#%%%%%%%%###%#%####%##%%%@%#@%%%%%%**%*#*@*+++*******+***+#+%**##@%%%%%%***%############%##%%%%%%#
#%%%%##%%%%%%@@%@%##%#%#*%%%%%%#%@%@#%**+%*#%%#*+*++*##**+**+#%+*%#%#%%%%#######*%#######%@%%%%%%#
#%%%%%%##%%*#*%@%@@%%%#%#%#*#%%%#*%%#%%%%*##***##***++++=*##+=%%%*@@%%#%%%%@##%%%#%%%#%%%%##%%%%%#
#%%%%%%%%%%#@%##*###%%%%@#%%#%*#%###%%*#**##*+*=+====++++#=-@@%*@%#*%#%*%%%%#%##*%#%@%@%%#%%%%%%%#
#%%%%%%%%%#@%=*#%%###%@+%%%%%%##%##+###%@#*#%*%+#*+***%%#**++*#*#-%%%#@#%#*%+@%@@@%%#*%%+%%%%%%%%#
#%%%%%%%%%%#@@%@@@%%#%@%%#%#%%%@%@%@##+**#%*#*%@******##*%@@@@#=@@%=****###@%#%#==#@@@#@%%%%%%%%%#
#%%%%#%%%%%%#*#%%#%###%*%@@%**+##*#*%%%%#**##%%##@%#==:+=****%%**+#%%@@@@##%*%*#@@%%%#*#%%*#%%%%%#
#%#%%%%%%%%%%%*%%%%@@%@@##%%@@%@@%@%*%%%@@%%*=**#+:+##@@@#*%%%@@%%%##++##%#@**%%%#%#%#@@%@@@%%%%%#
#%%%%%%%%%%%%@%#%###**-++###+##%#%*+*+#%%@@@@##%*@+++ -+*+=*+#*+###@@@@@%%%#%%##%*@%%%%#%####%%%%#
#%%%%%%%%%%%%%**@@@@%@@@@@%##+#####%@@%=-: .+#*#:+%@#%%-@@@@@@@-#%*@%#%@#%#%%%%%##%%@%%##**%%%%%%#
#%%%#%%%%%%%%##@#%%%%%%%%%%%%@@%@@%*+@@@@@@@@%*:###+:+%+*##@%+%%@#.:##*%*%%@%%%%%%%+%#@%*@%%%%%%%#
#%%%%%%%%%%%%%*@#%%#*%%@%@@%%*#@##@%#%%##%%##%@%@%%%*##+*%@=#***@@@@@%@#%%##%%@@#%@@@@%#%%%%%%%%%#
#%%%%%%%%%%%%#%%##%%%%*#*##+@@%*%+*@%%@@%%%#%%#*####***++=+#**%#%###%+%#%%*%+**#%*%#+=#%%%%%%%%%%#
#%%%%%%%%##%%%@@#%%%%@%%@%%#%%*@#@%#%+*+**%#%##@%***#*%@@@%%%*###@#@@*+%%%%@@@@%#%%@%@%%%%%%%%%%%#
#%%%%%%%@######*%%*%%@*@#@#%%#%*#%#%@@%@@#%*=*%#*#%+##**#*@%%#%#+%*%%@@%%%%%%%%%%%%%*%%%%%%%%%%%%#
#%%%%%%%##%%%%%%%#**=#%%=++*#%%@%#*%#%%####@*%%%%.*+@#%%-%-#%%@@@#*@%%%%%%%%%%%%%%%#%%%%%%%%%%%%%#
#######*#########%%%%%#%%%%%=%+##+**#%+*+*##*%+*##%#=+*######***##%*###########+*#*###############
