 ..................................................................................................
 ..................................................................................................
 ..................................................................................................
 ..................................................................................................
 ..................................................................................................
 ..................................................................................................
 ..................................................................................................
 ..................................................................................................
 .............................................-+#%%#+-.............................................
 ........................................=#*=:=......=:=*#=:.......................................
 ....................................#%=..:-............:-..=%#....................................
 ................................-#+...==..................==...=#=................................
 ..............................=#*::-%:.....:--======--:.....:#=::=#+..............................
 .............................--#..*#:...*%%%%%%%%%%%%%%%%#....*#..#=-.............................
 ...........................:.:=-.#=+...##-==+***###**+==-##...=+#::*:.-...........................
 ..........................:..:*=#**...**==-+==========+-==+#...*+#++-:..:.........................
 ........................-...-*=#-+-..=#=====-+======+-=====#*...+-*+#:...-........................
 ......................=-...-=##-=+...#=======--====-========#:..+=-*#+:...:+......................
 .....................-....::%#--*:..==========================...*--*%-:....:.....................
 ...................-.....:=#####+................................=####%=-.....:...................
 .................-......-:*=....:.................................:...:#.-:.....-.................
 ................:....::.:*=....-..::..............................=....:#:.::.....:...............
 ............:#+....::..-#%%%%%#*%%%%%%%%%%%%%%%%%%%%%%%%%%%%%%%%%%##%%%%%%-..::....-++............
 ...........=**%#*########%%%%%#%%%%%%%%%%%%%%%%%%%%%%%%%%%%%%%%%%%%*%%%%%%%##########*+...........
 ..................................:........:.......:.:.:..........................................
 ..................................................................................................
 ..................................................................................................
 ..................................................................................................
 ..................................................................................................
 ..................................................................................................
 ..................................................................................................
 ..................................................................................................
 ..................................................................................................
 ..................................................................................................