....................................................................................................
....................................................................................................
....................................................................................................
....................................................................................................
....................................................................................................
................................................-@@-................................................
..............................................=@@@@@@=..............................................
............................................-@#@@%%@@#@=............................................
..........................................-@+%@@:-::@@%=@-..........................................
........................................-@+=@@=..++..=@@=+@=........................................
......................................-@+:@@%..-@@@@=..%@@:=@-......................................
....................................-@+.#@@:.+@@@@@@@@+.:@@#.+@-....................................
..................................-@+.-@@*.+@@@@@@@@@@@@*.+@@-.=@=..................................
................................=@+..%@@.*#+===--==--===+#+.@@%..=@=................................
..............................:@=..+@@==....................=-@@+..=@:..............................
............................:@*..:@@%-.....-%@@@@@@@@@@%-.....-#@@:..+@:............................
..........................:@*...#@@=...-%@%+-....#+....-+%@%:...=@@#...+@:..........................
.........................+@%@%*@@%...:@%%*.......*+.......*#%@:...%@@*#@%@+.........................
........................#@...-@@-...=@*@@:.......*+.......-@@#@-...-@@-...@#........................
.......................=@:..=@@-....@#@@*........*+........%@@*%....+@@=..:@+.......................
.....................-.%=..*@%:....-@*@@:........*+........:@@#@.....:@@+..=%.-.....................
....................-.+#..#@%+:....%%@@*.........*+.........%@%@#....:+%@*..#=.-....................
..................-..-@..%%+#.#...:@%@@..........*+..........@@*@....+.%+%%..@-..-..................
.................-..:@..@++@-::...-@%@-..........*+..........=@%@-...=.-@++@..@...-.................
...............*....@:.@+=**.-....%@@+...........*+...........+@@#....=.#*=+@:=%....+...............
.............:%....%=-@+=+@..+...:@#+............*+............##@....:..@+=+@-=#....%:.............
............-.....=#+@===#=.::...++*.............*+.............*+*...=..+#===@=%-.....-............
...........-.....-@#@+==*%..+....@@@.............*+.............@@%....+..%+==+@#@:.....-...........
.........-......-@%@+===%-..-...*@+@.............*+............:@@@-...:..=%===+@*@:......:.........
........-......:%@@@@@@@*..-....@@%@.............*+............-@+@#...:...#@@@@@@@#-......-........
......=......=.%@@.........=...=@#@@:............*+............=@@%@....%.........@@#.-......:......
.....-.....=..#@@..............@@%@@=............*+............+@@#@%....:.........@@=..=.....-.....
...-.....+...=@@..........#...:@@#@@-............#*............+@@#@@:...=.........:@@-...=....:-...
..:....+....-@@:.........-....@@%-::::::::::::::-*+-::::::::::::::+@@*...-..........:@@:...:+....-..
-.@*.+.....=@@@@@@@@@@@@@+@@@@@@@@@@@@@@@@@@@@@@@@@@@@@@@@@@@@@@@@@@@@@@@@@@@@@@@@@@@@@@:....:=.*@.-
...%*....++@@@@@@@@@@@@@#@@@@@@@@@@@@@@@@@@@@@@@@@@@@@@@@@@@@@@@@@@@@@@@@@%@@@@@@@@@@@@@@==....#%...
.-**@%#**##*##*****%##*@@%#######################%%#####################%%%%%*##%*****##*#***%%@#*-.
....:-==--:...-..-=-:......:...::........:::.:.......:.:::..........:...-......:-=-..-...:--==-:....
....................................................................................................
....................................................................................................
....................................................................................................
....................................................................................................
....................................................................................................
....................................................................................................