
 @@@@@@@@@@@@@@@@@@@@@@@@@@                    %@@@@                    .@@@@@@@@@@@@@@@@@@@@@@@@@@
 @@@@@@@@@@@@@@@@@@@@@@@@                     @@@@@@@@                    :@@@@@@@@@@@@@@@@@@@@@@@@
 @@@@@@@@@@@@@@@@@@@@@@*                    @@@  @@  @@@                    @@@@@@@@@@@@@@@@@@@@@@@
 @@@@@@@@@@@@@@@@@@@@@                    @@@    @@    @@@                    @@@@@@@@@@@@@@@@@@@@@
 @@@@@@@@@@@@@@@@@@@                    @@@      @@      @@@                    @@@@@@@@@@@@@@@@@@@
 @@@@@@@@@@@@@@@@@                    @@@        @@       :@@%                   :@@@@@@@@@@@@@@@@@
 @@@@@@@@@@@@@@@                    @@@          @@         =@@-                   @@@@@@@@@@@@@@@@
 @@@@@@@@@@@@@+                   =@@+           @%           @@@                    @@@@@@@@@@@@@@
 @@@@@@@@@@@@                   :@@-             @@             @@@                    @@@@@@@@@@@@
 @@@@@@@@@@                    @@@             @@@@@#             @@@                    @@@@@@@@@@
 @@@@@@@@                    @@@             *@@    @@-             @@@                   :@@@@@@@@
 @@@@@@                    @@@             %@@        @@#             @@@                   @@@@@@@
 @@@@.                   #@@             .@@            @@              @@.                   @@@@@
 @@# @@@               @@@             :@@     @@@@@@     @@             =@@                @@@ @@@
 -       :@@=        -@@              @@    @@    :   @@    @@             #@@          @@-       @
               @@+  @@@             @@   @@       :      @@   @@             @@@  :@@
                  @@@:@*          @@   @*         :        @@   @@          :@+@@@
                *@@@       @:   @@   @            :          =@   @@    @       @@@
               @@@@           @@    @             :           %@   *@@           @@@@
              @@  :          @@:    @             :            @    .@@          @  @@
            @@.  @         @@:     @ @            :           -%@     @@-         @  @@
           @@   =         @@       @:             :            #@       @@        :    @+
          @@   **        @@       .:.             :             *        @@        @    @@
         @=    @        @@        %               .              @        @@        @    @@
        @@@@@@*        @@                         .              #         @@        #@@@@@@
                      @@         @+               .              @@         @@
                     @+          @                :               @          %@
                   =@           @  =             .:                @           @:
   :              @@*     :-@*+@+%#@@@@###%##@@%++++%@@%#****@@@@@@@@+*@-.     @@-
  :           @@@@@@@@@@@@@@@@@@@@@@@@@@@@@@@@@@@@@@@@@@@@@@@@@@@@@@@@@@@@@@@@@@@@@@@@
         %@@@@@@@@@@@@@@@@@@ *@                          :          :@+ @@@@@@@@@@@@@@@@@@:
    #@@@@@@@@@@@@@@@@@@@    *@=%                                     @@=    @@@@@@@@@@@@@@@@@@@*
 @@@@@@@@@@@@@@@@@@@@                  :@@      #@#       @@                  :@@@@@@@@@@@@@@@@@@@@
 @@@@@@@@@@@@@@@@@                    =@@.     @@@@@      @@@        .:*:         @@@@@@@@@@@@@@@@@
 @@@@@@@@@@@@@@            @@@       @@@@       %@@       @@@@*       @@@            @@@@@@@@@@@@@@
 @@@@@@@@@@                         @@@@                    @@@@        #               .@@@@@@@@@@
 @@@@@@@-                     =  -@@@@@@@     *     @     @@@@@@@@                         @@@@@@@@
 @@@@+#@@@@@@@@@@@@@@@@@@@@=    *@@@@@@       @     @        @@@@@@@    @@@@@@@@@@@@@@@@@@@@@*#@@@@
 @@@@@@@@@@@@@@@@@@@@@@@@@@@@@@ @@@@@@@@@      @@@@@      *@@@@@@@@@ @@@@@@@@@@@@@@@@@@@@@@@@@@@@@@
 @@@@@@@@@@@@@@@@@@@@@@@@@@**@@@@@@@@@@@@@*   %@@@@@@   :@@@@@@@@@@@@@@*#@@@@@@@@@@@@@@@@@@@@@@@@@@
 @@@@@@@@@@@@@@@@@@@@@@@@@@@@@@@@@@@@@@@@@:@@@@@@@@@@@@@*@@@@@@@@@@@@@@@@@@@@@@@@@@@@@@@@@@@@@@@@@@
